反送中已核實資訊頻道	antiextraditionverifiednews
612 reminder	reminder612
Scott Scout 認證哨兵消息主頻道	scottscout
[反送中]Fact Check Channel	antielabfactchecking
前線實時新聞直播（及 獨家實時消息）	realtimenewsbroadcasts
HK Confirmed Sightings Channel	hkiswatching
氣象巴打⛑高登連登氣象台聯合頻道（公測中）	weatherjj
2019香港天氣及風暴追擊|	windseason2019
香港TG新聞及資訊廣播 HKTGB	hktgb
大消物 (物資•車手•實況•失物)	bignewsmaterial
愛心飯堂channel	freelovehk
港島交通台 Island Traffic Channel	islandalliance
無天理 有地理	Hongkongmyfuture
《背水一戰馬拉松路面目測》	juneforstfuneral
全港交通消息	HK_Traffic_News
⚠️反送中 文宣谷 Channel⚠️	hkstandstrong_promo
📺 文宣組 圖文直播台 Live	hongkongstandstrong_live
（反送中 文宣谷）國際 Channel	hkstandstrong_promo_int
777文宣傳播稿件大合集	hkposter777
香港01 官方頻道	hk01official
香港蘋果日報	appledailyhk
壹週刊 Next	Nextplushk
端傳媒 Initium Media	the_InitiumMedia
香港獨立媒體網	inmediahknet
RTHK即時新聞	rthk_new_c
香港電台 RTHK 中文新聞	rthk_news
Now 新聞 ALERT	nowtv_news
有線新聞	cabletv_news
無綫新聞 快訊	tvb_news
中大學生會消息發佈	cusunews
城大人最新消息發佈	cityuchannel
民間人權陣線資訊頻道	CivilHumanRightsFront
青年新政 Youngspiration	youngspiration
本土民主前線公告頻道	forltkelectionsoffice
香港眾志 Demosistō 頻道	DemosistoOfficial
香港民族陣綫 陣地廣播	HKNFChannel
星火同盟 抗爭支援	sparkalliancehk
和理非終極升級罷工反送中（職工盟）	unionsforHK
老豆搵仔	Dadfindboy
粉蛆展覽館（習吃屎暴斃，中港家庭團聚）	iamchinese2
支纳维基	realZhinawiki
香港自由之書	hkrevolutiondocument
香港編年史 — 開發資訊頻道	hkchronicles
香港反黑組🧟‍♀🧟‍♂	HKAntiBlack